111111111111111111111111111111111111111111111
100000000000000000000011000000000000000000001
100000000000000000000011000000000000000000001
100000000000000000000000000000000000000000001
100000000000000000000000000000000000000000001
100000011100000000000000000000000001110000001
100000000000000000000000000000000000000000001
100000000000000001110000001110000000000000001
100000000000000001000000000010000000000000001
100000000000000000000000000000000000000000001
100001100000000000000000000000000000001100001
100000100000000000000000000000000000001000001
100000100000000000000000000000000000001000001
100000100000000000000000000000000000001000001
100000100000110000000000000000011000001000001
100000100000110000000000000000011000001000001
100000100000000000000000000000000000001000001
100000100000000000000000000000000000001000001
100000100000000000000000000000000000001000001
100001100000000000000000000000000000001100001
100000000000000000000000000000000000000000001
100000000000000001000000000010000000000000001
100000000000000001110000001110000000000000001
100000000000000000000000000000000000000000001
100000011100000000000000000000000001110000001
100000000000000000000000000000000000000000001
100000000000000000000000000000000000000000001
100000000000000000000011000000000000000000001
100000000000000000000011000000000000000000001
111111111111111111111111111111111111111111111