111111111111111111111111111111111111111111111
100000000000000000000000000000000000000000001
100000000000000000000000000000000000000000001
100000000000000000000000000000000000000000001
100000000000000000000000000000000000000000001
100000000000000000000110000000000000000000001
100000000000000000000110000000000000000000001
100000000000000000000110000000000000000000001
100000000000000000000110000000000000000000001
100000000000000000000000000000000000000000001
100000000000000000000000000000000000000000001
100001100000000000000000000000000000001100001
100000100000000000000000000000000000001000001
100000100000000000000000000000000000001000001
100000100001111100000000000011111000001000001
100000100001111100000000000011111000001000001
100000100000000000000000000000000000001000001
100000100000000000000000000000000000001000001
100001100000000000000000000000000000001100001
100000000000000000000000000000000000000000001
100000000000000000000000000000000000000000001
100000000000000000000110000000000000000000001
100000000000000000000110000000000000000000001
100000000000000000000110000000000000000000001
100000000000000000000110000000000000000000001
100000000000000000000000000000000000000000001
100000000000000000000000000000000000000000001
100000000000000000000000000000000000000000001
100000000000000000000000000000000000000000001
111111111111111111111111111111111111111111111