111111111111111111111111111111111111111111111
100000000000000000001111100000000000000000001
100000000000000000000111000000000000000000001
100000000000000000000010000000000000000000001
100000000000000000000000000000000000000000001
100000100000000000000000000000000000001000001
100000100000000000000000000000000000001000001
100000100000000000000000000000000000001000001
100000100000000000000000000000000000001000001
100000100000000000000000000000000000001000001
100000100000000000011111110000000000001000001
100000000000000000000000000000000000000000001
100000000000000000000000000000000000000000001
100000000000100000000000000000000100000000001
100000000000100000000000000000000100000000001
100000000000100000000000000000000100000000001
100000000000100000000000000000000100000000001
100000000000000000000000000000000000000000001
100000000000000000000000000000000000000000001
100000100000000000011111110000000000001000001
100000100000000000000000000000000000001000001
100000100000000000000000000000000000001000001
100000100000000000000000000000000000001000001
100000100000000000000000000000000000001000001
100000100000000000000000000000000000001000001
100000000000000000000000000000000000000000001
100000000000000000000010000000000000000000001
100000000000000000000111000000000000000000001
100000000000000000001111100000000000000000001
111111111111111111111111111111111111111111111