111111111111111111111111111111111111111111111
100000000000000000000010000000000000000000001
100000000000000000000010000000000000000000001
100000000000000000000010000000000000000000001
100000000000000000000000000000000000000000001
100000000000000000000000000000000000000000001
100000111110000000000000000000000011111000001
100000000000000000000000000000000000000000001
100000000000000000000010000000000000000000001
100000000000000000000010000000000000000000001
100000000000000000001111100000000000000000001
100000000100000000000000000000000001000000001
100000000100000000000000000000000001000000001
100000000100000000000000000000000001000000001
100000000111100000000000000000001111000000001
100000000111100000000000000000001111000000001
100000000100000000000000000000000001000000001
100000000100000000000000000000000001000000001
100000000100000000000000000000000001000000001
100000000000000000001111100000000000000000001
100000000000000000000010000000000000000000001
100000000000000000000010000000000000000000001
100000000000000000000000000000000000000000001
100000111110000000000000000000000011111000001
100000000000000000000000000000000000000000001
100000000000000000000000000000000000000000001
100000000000000000000010000000000000000000001
100000000000000000000010000000000000000000001
100000000000000000000010000000000000000000001
111111111111111111111111111111111111111111111